##########
#  #  #  #
#  # #S# #
#E #  #  #
#  #     #
#  #     #
##########
