##########
#  #     #
#  #  S  #
#E #     #
#  #     #
#  #     #
##########
